The lights mounted on the ceiling nearly blind you as you wake up. You slowly stand up, and the sound of your foot stepping on a wooden floor startles you. You quickly jump up, and find yourself standing front and center of a stage. Coming to your senses, you realize that you are the only person in the room. No people sitting in the studio audience seats, no people operating lights or cameras, no people running around backstage, just you.

A visceral feeling hits your gut. You have to escape.

TV Dream
An Interactive Fiction by kroberts21
Release 1 / Serial number 190304 / Inform 7 build 6M62 (I6/v6.33 lib 6/12N) SD

Stage Middle
A big wooden cutout of a yellow house with a red roof and a red door stands front and center of the stage, right behind where you were laying down. Around the house stands three taller wooden cutouts of trees.

>e
Stage Left
Here there is a large, long, round cutout resembling some sort of lake. One giant fake oak tree stands closer to the house, with a large key dangling from its branches.

One of those long plastic grabber things is on the floor at the base of the tree. You can't seem to figure out why it's there.

On Big Oak Tree is big key.

You can also see grabber here.

>g
You can't go that way.

>get grabber
Now you can get the key.

>get keu
You can't see any such thing.

>oops key
Taken.

>w
Stage Middle
Stage Middle

You can see a red door here.

>i
You are carrying:
  big key
  grabber

>unlock door with big key
You unlock the red door.

>open door
You open the red door.

>n
Backstage
It's kind of dark. From the lights on the top of the stage, you can make out an empty lightbulb socket embedded in the ceiling.

You can see a red door here.

>x safe
safe

Passcode?

>231
You have unlocked the safe.
That's not a verb I recognise.

* * *

>e
Stage Left
Here there is a large, long, round cutout resembling some sort of lake. One giant fake oak tree stands closer to the house, with a large key dangling from its branches.

One of those long plastic grabber things is on the floor at the base of the tree. You can't seem to figure out why it's there.

On Big Oak Tree is big key.

You can also see grabber here.

>get grabber
Now you can get the key.

>get key
Taken.

>drop grabber
Dropped.

>w
Stage Middle
Stage Middle

You can see a red door here.

>s
Studio Audience
Right in front of the stage, you see two cameras and two lights fixed on low stands.

Looking back at the whole stage, you see 2 trees in stage left, 3 trees in stage middle, and 1 tree in stage right. Peculiar.

left red

middle blue

right green

You can see a black door here.

>x lights
The lights they use on the show. They are currently off.

In Lights is lightbulb.

>get lightbulb
You try pulling it out, but it's fixed in place.

>unscrew lightbulb
You unscrew the lightbulb.

>take lightbulb
Taken.

>n
Stage Middle
Stage Middle

You can see a red door here.

>unlock door with key
You unlock the red door.

>open door
You open the red door.

* * *

>n
Backstage
It's kind of dark. From the lights on the top of the stage, you can make out an empty lightbulb socket embedded in the ceiling.

You can see a red door here.

>put lightbulb in socket
You screw in the lightbulb.

>turn on light
You turn on the light. Now you can see a safe.

>x safe
safe

Passcode?

>undo
Backstage
[Previous turn undone.]

>unlock safe
(with big key)
It doesn't look like the safe is unlockable with a key.

>x safe
safe

Passcode?

* * *

>231
You have unlocked the safe.
That's not a verb I recognise.

>open safe
You open the safe, revealing small key.

>take key
(small key)
Taken.

>s
Stage Middle
Stage Middle

You can see a red door here.

>s
Studio Audience
Right in front of the stage, you see two cameras and two lights fixed on low stands.

Looking back at the whole stage, you see 2 trees in stage left, 3 trees in stage middle, and 1 tree in stage right. Peculiar.

left red

middle blue

right green

You can see a black door here.

* * *

>get key
Taken.

>w
Stage Middle
A big wooden cutout of a yellow house with a red roof and a red door stands front and center of the stage, right behind where you were laying down. Around the house stands three taller wooden cutouts of trees.

>s
Studio Audience
Right in front of the stage, you see two cameras and two lights fixed on low stands.

Immediately, you notice something peculiar. You turn towards the stage, then towards the chairs. Facing the stage, all the chairs on the left are red, in the middle blue, and on the right green.

>x lights
The lights they use on the show. They are currently off.

In Lights is lightbulb.

>take lightbulb
You try pulling it out, but it's fixed in place.

>unscrew lightbulb
You unscrew the lightbulb.

* * *

>x lights
The lights they use on the show. They are currently off.

In Lights is lightbulb.

>unscrew lightbulb
You unscrew the lightbulb.

* * *

>take lightbulb
Taken.

>n
Stage Middle
A big wooden cutout of a yellow house with a red roof and a red door stands front and center of the stage, right behind where you were laying down. Around the house stands three taller wooden cutouts of trees.

>unlock door
What do you want to unlock the red door with?

>unlock door with key
You unlock the red door.

* * *

>open door
You open the red door.

>n
Backstage
A single lightbulb gives off a warm yellow-orange glow, making it just bright enough to make out some details in the room.

* * *

>n
Stage Middle
A big wooden cutout of a yellow house with a red roof and a red door stands front and center of the stage, right behind where you were laying down. Around the house stands three taller wooden cutouts of trees.

>unlock door with key
You unlock the red door.

* * *

>open door
You open the red door.

>n
Backstage
It's kind of dark. From the lights on the top of the stage, you can make out an empty lightbulb socket embedded in the ceiling.

>put lightbulb in socket
You screw in the lightbulb.

>turn on light
You turn on the light. Now you can see a safe embedded in the center of the back wall.

>look
Backstage
A single lightbulb gives off a warm yellow-orange glow, making it just bright enough to make out some details in the room.

>x safe
It has a number pad and a seven-segment display, almost like a microwave, but super secure. The display is divided into three segments, red, blue, and green.

Passcode?

>231
You have unlocked the safe.
That's not a verb I recognise.

* * *

>take lightbulb
Taken.

>unscrew lightbulb
Nothing obvious happens.

* * *

>w
Stage Middle
A big wooden cutout of a yellow house with a red roof and a red door stands front and center of the stage, right behind where you were laying down. Around the house stands three taller wooden cutouts of trees.

>unlock door
What do you want to unlock the red door with?

* * *

>open door
You open the red door.

>n
Backstage
safe

You can see a red door here.

>x safe
safe

>231
You unlock the safe, revealing a small key.

>open safe
You open the safe, revealing small key.

>pick up small key
Taken.

>i
You are carrying:
  small key
  big key
  Grabber

>s
Stage Middle
Stage Middle

You can see a red door here.

>s
Studio Audience
2 trees in stage left, 3 trees in stage middle, and 1 tree in stage right. Peculiar.

left red

middle blue

right green

You can see a black door here.

>unlock door
What do you want to unlock the black door with?

>unlock door with small key
You unlock the black door.

>open door
    *** You win ***

Would you like to RESTART, RESTORE a saved game, QUIT or UNDO the last command?

>s
Please give one of the answers above.

Would you like to RESTART, RESTORE a saved game, QUIT or UNDO the last command?

* * *

>w
Stage Middle
A big wooden cutout of a yellow house with a red roof and a red door stands front and center of the stage, right behind where you were laying down. Around the house stands three taller wooden cutouts of trees.

>unlock door with key
You unlock the red door.

* * *

>n
Backstage
It's kind of dark. From the lights on the top of the stage, you can make out an empty lightbulb socket embedded in the ceiling.

You can see a red door here.

>231
You unlock the safe.

>open safe
You open the safe.

* * *

>x safe
safe

Passcode?

>s
The safe remains closed.

Would you like to try again? (Yes or No)

>s
Would you like to try again? (Yes or No)

>x lights
Would you like to try again? (Yes or No)

>unscrew lightbulb
Would you like to try again? (Yes or No)

>take lightbulb
Would you like to try again? (Yes or No)

* * *

>n
You can't go that way.

>put lightbulb in socket
You can't see any such thing.

>turn on light
You can't see any such thing.

>x safe
safe

Passcode?

>231
You have unlocked the safe, revealing a small key.
That's not a verb I recognise.

>take key
Taken.

>i
You are carrying:
  big key
  grabber

>take small key
You can't see any such thing.

>open safe
You open the safe, revealing small key.

* * *

>take key
(small key)
Taken.

>i
You are carrying:
  small key
  big key
  grabber

>s
Stage Middle
Stage Middle

You can see a red door here.

* * *

>s
Studio Audience
Right in front of the stage, you see two cameras and two lights fixed on low stands.

Looking back at the whole stage, you see 2 trees in stage left, 3 trees in stage middle, and 1 tree in stage right. Peculiar.

left red

middle blue

right green

You can see a black door here.

>unlock door
What do you want to unlock the black door with?

>unlock door with key
Which do you mean, small key or big key?

>unlock door with small key
You unlock the black door.

>s
(first opening the black door)

    *** You win ***

Would you like to RESTART, RESTORE a saved game, QUIT or UNDO the last command?

* * *

>open door
You open the red door.

>s
Studio Audience
Right in front of the stage, you see two cameras and two lights fixed on low stands.

Looking back at the whole stage, you see 2 trees in stage left, 3 trees in stage middle, and 1 tree in stage right. Peculiar.

left red

middle blue

right green

You can see a black door here.

* * *

>get grabber
Now you can get the key.

>use grabber
That's not a verb I recognise.

* * *

>get grabber
Now you can get the key.

>x grabber
You see nothing special about grabber.

>get key
Taken.

* * *

>n
Backstage
It's kind of dark. From the lights on the top of the stage, you can make out an empty lightbulb socket embedded in the ceiling.

>s
Stage Middle
A big wooden cutout of a yellow house with a red roof and a red door stands front and center of the stage, right behind where you were laying down. Around the house stands three taller wooden cutouts of trees.

>s
Studio Audience
Right in front of the stage, you see two cameras and two lights fixed on low stands.

Immediately, you notice something peculiar. You turn towards the stage, then towards the chairs. Facing the stage, all the chairs on the left are red, in the middle blue, and on the right green.

You can see a black door here.

>x cameras
You can't see any such thing.

>x lights
The lights they use on the show. They are currently off.

In Lights is lightbulb.

>take lightbulb
You try pulling it out, but it's stuck. However, you try again, and you feel it wiggle around a little bit.

>unscrew lightbulb
You unscrew the lightbulb.

* * *

>n
Stage Middle
A big wooden cutout of a yellow house with a red roof and a red door stands front and center of the stage, right behind where you were laying down. Around the house stands three taller wooden cutouts of trees.

>n
Backstage
It's kind of dark. From the lights on the top of the stage, you can make out an empty lightbulb socket embedded in the ceiling.

* * *

>undo
Backstage
[Previous turn undone.]

>s
Stage Middle
A big wooden cutout of a yellow house with a red roof and a red door stands front and center of the stage, right behind where you were laying down. Around the house stands three taller wooden cutouts of trees.

* * *

>s
Studio Audience
Right in front of the stage, you see two cameras and two lights fixed on low stands.

Immediately, you notice something peculiar. You turn towards the stage, then towards the chairs. Facing the stage, all the chairs on the left are red, in the middle blue, and on the right green.

You can see a black door here.

>n
Stage Middle
A big wooden cutout of a yellow house with a red roof and a red door stands front and center of the stage, right behind where you were laying down. Around the house stands three taller wooden cutouts of trees.

* * *

>n
Backstage
It's kind of dark. From the lights on the top of the stage, you can make out an empty lightbulb socket embedded in the ceiling.

>turn onlight
You can't see any such thing.

>turn on light
That's already on.

>x safe
safe

Passcode?

* * *

>open safe
You open the safe, revealing small key.

>pick up key
(small key)
Taken.

>s
Stage Middle
A big wooden cutout of a yellow house with a red roof and a red door stands front and center of the stage, right behind where you were laying down. Around the house stands three taller wooden cutouts of trees.

* * *

>s
Studio Audience
Right in front of the stage, you see two cameras and two lights fixed on low stands.

Immediately, you notice something peculiar. You turn towards the stage, then towards the chairs. Facing the stage, all the chairs on the left are red, in the middle blue, and on the right green.

You can see a black door here.

>unlock door
What do you want to unlock the black door with?

* * *

>unlock door with small key
You unlock the black door.

>open door
    ***  ***

Would you like to RESTART, RESTORE a saved game, QUIT or UNDO the last command?

* * *

>e
Stage Left
Here there is a large, long, round cutout resembling some sort of lake. One giant fake oak tree stands closer to the house, with a large key dangling from its branches.

One of those long plastic grabber things is on the floor at the base of the tree. You can't seem to figure out why it's there.

On Big Oak Tree is big key.

You can also see grabber here.

>get key
You can't quite reach the key. It's too high up.

>pick up grabber
Taken.

>use grabber
That's not a verb I recognise.

>get key
Taken.

>w
Stage Middle
Stage Middle

You can see a red door here.

>unlock door
What do you want to unlock the red door with?

* * *

>x safe
safe

>unlock safe
What do you want to unlock the safe with?

* * *

>e
Stage Left
Here there is a large, long, round cutout resembling some sort of lake. One giant fake oak tree stands closer to the house, with a large key dangling from its branches.

One of those long plastic grabber things is on the floor at the base of the tree. You can't seem to figure out why it's there.

On Big Oak Tree is big key.

You can also see grabber here.

>pick up grabber
Taken.

>get key
Taken.

>e
You can't go that way.

>w
Stage Middle
Stage Middle

You can see a red door here.

* * *

>unlock door with key
You unlock the red door.

>open dor
You can't see any such thing.

>oops door
You open the red door.

>n
Backstage
You can see a red door here.

* * *

>use grabber
That's not a verb I recognise.

>drop grabber
Dropped.

>pick up grabber
Taken.

* * *

>e
Stage Left
Here there is a large, long, round cutout resembling some sort of lake. One giant fake oak tree stands closer to the house, with a large key dangling from its branches.

One of those long plastic grabber things is on the floor at the base of the tree. You can't seem to figure out why it's there.

On Big Oak Tree is big key.

You can also see grabber here.

>take key
You can't quite reach the key. It's too high up.

>pick up grabber
Taken.

>take key
Taken.

>i
You are carrying:
  Key
  Grabber

* * *

>e
Stage Left
Here there is a large, long, round cutout resembling some sort of lake. One giant fake oak tree stands closer to the house, with a large key dangling from its branches.

One of those long plastic grabber things is on the floor at the base of the tree. You can't seem to figure out why it's there.

On Big Oak Tree is big key.

You can also see grabber here.

>w
Stage Middle
Stage Middle

You can see a red door here.

>w
Stage Right

>e
Stage Middle
Stage Middle

You can see a red door here.

>e
Stage Left
On Big Oak Tree is big key.

You can also see grabber here.

>get grabber
Now you can get the key.

* * *

>n
Backstage
safe

You can see a red door here.

>unlock safe
What do you want to unlock the safe with?

* * *

>open door
It seems to be locked.

>i
You are carrying nothing.

>e
Stage Left
On Big Oak Tree is big key.

You can also see Grabber here.

>w
Stage Middle
Stage Middle

You can see a red door here.

* * *

>e
Stage Middle
Stage Middle

You can see a red door here.

>e
Stage Left
On Big Oak Tree is big key.

You can also see Grabber here.

>pick up grabber
Taken.

* * *

>w
Stage Middle
Stage Middle

You can see a red door here.

>unlock door with key
You unlock the red door.

* * *

>x safe
safe

>open safe
It seems to be locked.

>unlock safe
What do you want to unlock the safe with?

* * *

>open door
It seems to be locked.

>w
Stage Right

* * *

>e
Stage Left
On Big Oak Tree is big key.

You can also see Grabber here.

>get key
You can't quite reach the key. It's too high up.

* * *

>open door
You open the red door.

>n
Backstage
You can see a red door here.

* * *

>w
Stage Right

>pick up key
Taken.

>e
Stage Middle
Stage Middle

You can see a red door here.

>unlock door
(with Key)
You unlock the red door.

>open door
You open the red door.

* * *

>s
Studio Audience
Right in front of the stage, you see two lights fixed on low stands. Oddly enough, there are no cameras. The lights look strange as well; they're loose.

Immediately, you notice another peculiar thing. You turn towards the stage, then towards the chairs. Facing the stage, all the chairs on the left are red, in the middle blue, and on the right green.

>n
Stage Middle
Stage Middle

You can see a red door here.

>e
Stage Left
On Big Oak Tree is big key.

You can also see Grabber here.

>get grabber
Taken.

>get key
Taken.

* * *

>unlock door
What do you want to unlock the red door with?

>with key
You can't see any such thing.

>unlock door with key
You unlock the red door.

* * *

>n
Backstage
safe

You can see a red door here.

>231
You unlock the safe, revealing a small key.

>i
You are carrying:
  big key
  Grabber

>pick up key
Taken.

>pick up small key
You can't see any such thing.

* * *

>s
Studio Audience
Right in front of the stage, you see two lights fixed on low stands. Oddly enough, there are no cameras. The lights look strange as well; they're loose.

Immediately, you notice another peculiar thing. You turn towards the stage, then towards the chairs. Facing the stage, all the chairs on the left are red, in the middle blue, and on the right green.

>s
(first opening the black door)
The door is locked. You are trapped.

>i
Please give one of the answers above.

Would you like to RESTART, RESTORE a saved game, QUIT or UNDO the last command?

>restart
The lights mounted on the ceiling nearly blind you as you wake up. You slowly stand up, and the sound of your foot stepping on a wooden floor startles you. You quickly jump up, and find yourself standing front and center of a stage. Coming to your senses, you realize that you are the only person in the room. No people sitting in the studio audience seats, no people operating lights or cameras, no people running around backstage, just you.

A visceral feeling hits your gut. You have to escape.

TV Dream
An Interactive Fiction by kroberts21
Release 1 / Serial number 190228 / Inform 7 build 6M62 (I6/v6.33 lib 6/12N) SD

Stage Middle
A big wooden cutout of a yellow house with a red roof and a red door stands front and center of the stage, right behind where you were laying down. Around the house stands three taller wooden cutouts of trees.

>i
You are carrying nothing.

>s
Studio Audience
Right in front of the stage, you see two cameras and two lights fixed on low stands.

Immediately, you notice something peculiar. You turn towards the stage, then towards the chairs. Facing the stage, all the chairs on the left are red, in the middle blue, and on the right green.

You can see a black door here.

>s
(first opening the black door)

    *** You Win ***

Would you like to RESTART, RESTORE a saved game, QUIT or UNDO the last command?

* * *

>aldkfjalsdkfjalskdfjalj
That's not a verb I recognise.

* * *

>s
(first opening the black door)
The door is locked. You are trapped.

>restart
The lights mounted on the ceiling nearly blind you as you wake up. You slowly stand up, and the sound of your foot stepping on a wooden floor startles you. You quickly jump up, and find yourself standing front and center of a stage. Coming to your senses, you realize that you are the only person in the room. No people sitting in the studio audience seats, no people operating lights or cameras, no people running around backstage, just you.

A visceral feeling hits your gut. You have to escape.

TV Dream
An Interactive Fiction by kroberts21
Release 1 / Serial number 190228 / Inform 7 build 6M62 (I6/v6.33 lib 6/12N) SD

Stage Middle
A big wooden cutout of a yellow house with a red roof and a red door stands front and center of the stage, right behind where you were laying down. Around the house stands three taller wooden cutouts of trees.

>n
(first opening the red door)
It seems to be locked.

>e
Stage Left
Here there is a large, long, round cutout resembling some sort of lake. One giant fake oak tree stands closer to the house, with a large key dangling from its branches.

One of those long plastic grabber things is on the floor at the base of the tree. You can't seem to figure out why it's there.

On Big Oak Tree is big key.

You can also see grabber here.

* * *

>s
Studio Audience
Right in front of the stage, you see two cameras and two lights fixed on low stands.

Immediately, you notice something peculiar. You turn towards the stage, then towards the chairs. Facing the stage, all the chairs on the left are red, in the middle blue, and on the right green.

You can see a black door here.

* * *

>s
(first opening the black door)
The door is locked. You are trapped.

>s
(first opening the black door)

>take lightbulb
You try pulling it out, but it's stuck. However, you try again, and you feel it wiggle around a little bit.

>take lightbulb
You try pulling it out, but it's stuck. However, you try again, and you feel it wiggle around a little bit.

>unscrew
(the black door)
It is fixed in place.

>unscrew light bulb
I only understood you as far as wanting to unscrew lightbulb.

>take lightbulb
You try pulling it out, but it's stuck. However, you try again, and you feel it wiggle around a little bit.

* * *

>n
Stage Middle
A big wooden cutout of a yellow house with a red roof and a red door stands front and center of the stage, right behind where you were laying down. Around the house stands three taller wooden cutouts of trees.

>e
Stage Left
Here there is a large, long, round cutout resembling some sort of lake. One giant fake oak tree stands closer to the house, with a large key dangling from its branches.

One of those long plastic grabber things is on the floor at the base of the tree. You can't seem to figure out why it's there.

On Big Oak Tree is big key.

You can also see grabber here.

>take grabber
Now you can get the key.

>take key
Taken.

>s
You can't go that way.

>e
You can't go that way.

>w
Stage Middle
A big wooden cutout of a yellow house with a red roof and a red door stands front and center of the stage, right behind where you were laying down. Around the house stands three taller wooden cutouts of trees.

>n
(first opening the red door)
It seems to be locked.

>unlock door with big key
You unlock the red door.

* * *

>n
Backstage
It's kind of dark. From the lights on the top of the stage, you can make out an empty lightbulb socket embedded in the ceiling.

>screw lightbulb
You unscrew the lightbulb.

>put lightbulb in socket
You screw in the lightbulb.

* * *

>turn on light
You turn on the light. Now you can see a safe embedded in the center of the back wall.

>x safe
It has a number pad and a seven-segment display, almost like a microwave, but super secure. The display is divided into three segments, red, blue, and green.

Passcode?

* * *

>take key
(small key)
Taken.

>s
Stage Middle
A big wooden cutout of a yellow house with a red roof and a red door stands front and center of the stage, right behind where you were laying down. Around the house stands three taller wooden cutouts of trees.

>s
Studio Audience
Right in front of the stage, you see two cameras and two lights fixed on low stands.

Immediately, you notice something peculiar. You turn towards the stage, then towards the chairs. Facing the stage, all the chairs on the left are red, in the middle blue, and on the right green.

>s
(first opening the black door)

>unlock door
What do you want to unlock the black door with?

>small key
You unlock the black door.

>open black door
You open the black door.

>s
Lot

    *** You Win ***

Would you like to RESTART, RESTORE a saved game, QUIT or UNDO the last command?

* * *

>s
(first opening the black door)
The door is locked. You are trapped.

>take chair
You can't see any such thing.

* * *

>s
Studio Audience
Right in front of the stage, you see two lights fixed on low stands. Oddly enough, there are no cameras. The lights look strange as well; they're loose.

Immediately, you notice another peculiar thing. You turn towards the stage, then towards the chairs. Facing the stage, all the chairs on the left are red, in the middle blue, and on the right green.

>take chair
They're bolted into the floor

>e
You can't go that way.

>n
Stage Middle
A big wooden cutout of a yellow house with a red roof and a red door stands front and center of the stage, right behind where you were laying down. Around the house stands three taller wooden cutouts of trees.

* * *

>unscrew lightbulb
You unscrew the lightbulb.

>screw lightbulb
You unscrew the lightbulb.

* * *

>s
Studio Audience
Right in front of the stage, you see two lights fixed on low stands. Oddly enough, there are no cameras. The lights look strange as well; they're loose.

Immediately, you notice another peculiar thing. You turn towards the stage, then towards the chairs. Facing the stage, all the chairs on the left are red, in the middle blue, and on the right green.

>x lighs
You can't see any such thing.

>x lights
The lights they use on the show. They are currently off.

In Lights is lightbulb.

* * *

>take lightbulb
Taken.

>i
You are carrying:
  lightbulb

>n
Stage Middle
Stage Middle

You can see a red door here.

>w
Stage Right

* * *

>put lightbulb in socket
You screw in the lightbulb.

>turn on light
You turn on the light. Now you can see a safe

>x safe
safe

Passcode?

* * *

>s
Studio Audience
Right in front of the stage, you see two lights fixed on low stands. Oddly enough, there are no cameras. The lights look strange as well; they're loose.

Immediately, you notice another peculiar thing. You turn towards the stage, then towards the chairs. Facing the stage, all the chairs on the left are red, in the middle blue, and on the right green.

>x lights
The lights they use on the show. They are currently off.

In Lights is lightbulb.

>take lightbulb
You unscrew the lightbulb, and take it out.

>i
You are carrying:
  lightbulb

* * *

>open door
You open the red door.

>n
Backstage
It's kind of dark

You can see a red door here.

* * *

>unscrew lightbulb
You unscrew the lightbulb.

>take lightbulb
You try pulling it out, but it's stuck. However, you try again, and you feel it wiggle around a little bit.

* * *

>x lights
The lights they use on the show. They are currently off.

In Lights is lightbulb.

>x cameras
You can't see any such thing.

>take lightbulb
You try pulling it out, but it's fixed in place.

* * *

>n
Stage Middle
Stage Middle

You can see a red door here.

>e
Stage Left
On Big Oak Tree is big key.

You can also see grabber here.

* * *

>n
Backstage
It's kind of dark. From the lights on the top of the stage, you can make out an empty lightbulb socket embedded in the ceiling.

You can see a red door here.

>i
You are carrying:
  big key
  lightbulb

>put lightbulb in socket
You screw in the lightbulb.

* * *

>turn on light
You turn on the light. Now you can see a safe

>x safe
You can't see any such thing.

>turn off light
You switch lightbulb off.

* * *

>unlock door
(with the red door)
(first taking the red door)
That's fixed in place.

* * *

>w
Stage Right
This part of the stage is pretty empty compared to the other two sections. Aside from the sky blue backdrop, there are two trees and a tall flagpole with a white flag.

>e
Stage Middle
A big wooden cutout of a yellow house with a red roof and a red door stands front and center of the stage, right behind where you were laying down. Around the house stands three taller wooden cutouts of trees.

>e
Stage Left
Here there is a large, long, round cutout resembling some sort of lake. One giant fake oak tree stands closer to the house, with a large key dangling from its branches.

One of those long plastic grabber things is on the floor at the base of the tree. You can't seem to figure out why it's there.

On Big Oak Tree is big key.

You can also see grabber here.

>get grabber
Taken.

* * *

>231
You unlock the safe, revealing a small key.

>pick up key
Taken.

>i
You are carrying:
  big key
  Grabber

>restart
Are you sure you want to restart?

>yes
TV Dream
An Interactive Fiction by kroberts21
Release 1 / Serial number 190222 / Inform 7 build 6M62 (I6/v6.33 lib 6/12N) SD

Stage Middle
Stage Middle

You can see a red door here.

>s
Studio Audience
2 trees in stage left, 3 trees in stage middle, and 1 tree in stage right. Peculiar.

* * *

>w
Stage Middle
Stage Middle

You can see a red door here.

>unlock door with big key
You unlock the red door.

* * *

>e
Stage Left
Here there is a large, long, round cutout resembling some sort of lake. One giant fake oak tree stands closer to the house, with a large key dangling from its branches.

One of those long plastic grabber things is on the floor at the base of the tree. You can't seem to figure out why it's there.

On Big Oak Tree is big key.

You can also see grabber here.

>n
You can't go that way.

>w
Stage Middle

>n
Backstage

>s
Stage Middle

>s
Studio Audience

* * *

>e
Stage Left
Here there is a large, long, round cutout resembling some sort of lake. One giant fake oak tree stands closer to the house, with a large key dangling from its branches.

One of those long plastic grabber things is on the floor at the base of the tree. You can't seem to figure out why it's there.

On Big Oak Tree is big key.

You can also see grabber here.

>pick up key
Taken.

* * *

>e
Stage Left
Here there is a large, long, round cutout resembling some sort of lake. One giant fake oak tree stands closer to the house, with a large key dangling from its branches.

One of those long plastic grabber things is on the floor at the base of the tree. You can't seem to figure out why it's there.

On Big Oak Tree is big key.

You can also see grabber here.

>s
You can't go that way.

>s
You can't go that way.

* * *

>e
You can't go that way.

>s
You can't go that way.

>w
Stage Middle
A big wooden cutout of a yellow house with a red roof and a red door stands front and center of the stage, right behind where you were laying down. Around the house stands three taller wooden cutouts of trees.

>s
Studio Audience
Right in front of the stage, you see two cameras and two lights fixed on low stands.

Immediately, you notice something peculiar. You turn towards the stage, then towards the chairs. Facing the stage, all the chairs on the left are red, in the middle blue, and on the right green.

You can see a black door here.

* * *

>s
(first opening the black door)

    *** You Win ***

Would you like to RESTART, RESTORE a saved game, QUIT or UNDO the last command?

>restart
The lights mounted on the ceiling nearly blind you as you wake up. You slowly stand up, and the sound of your foot stepping on a wooden floor startles you. You quickly jump up, and find yourself standing front and center of a stage. Coming to your senses, you realize that you are the only person in the room. No people sitting in the studio audience seats, no people operating lights or cameras, no people running around backstage, just you.

A visceral feeling hits your gut. You have to escape.

TV Dream
An Interactive Fiction by kroberts21
Release 1 / Serial number 190228 / Inform 7 build 6M62 (I6/v6.33 lib 6/12N) SD

Stage Middle
A big wooden cutout of a yellow house with a red roof and a red door stands front and center of the stage, right behind where you were laying down. Around the house stands three taller wooden cutouts of trees.

>e
Stage Left
Here there is a large, long, round cutout resembling some sort of lake. One giant fake oak tree stands closer to the house, with a large key dangling from its branches.

One of those long plastic grabber things is on the floor at the base of the tree. You can't seem to figure out why it's there.

On Big Oak Tree is big key.

You can also see grabber here.

* * *

>open door
You open the red door.

>s
Studio Audience
Right in front of the stage, you see two cameras and two lights fixed on low stands.

Immediately, you notice something peculiar. You turn towards the stage, then towards the chairs. Facing the stage, all the chairs on the left are red, in the middle blue, and on the right green.

You can see a black door here.

>x lights
The lights they use on the show. They are currently off.

In Lights is lightbulb.

>get lightbulb
You try pulling it out, but it's stuck. However, you try again, and you feel it wiggle around a little bit.

>unscrew lightbulb
You unscrew the lightbulb.

* * *

>open safe
You open the safe, revealing small key.

>take ey
You can't see any such thing.

>oops key
(small key)
Taken.

>s
Stage Middle
A big wooden cutout of a yellow house with a red roof and a red door stands front and center of the stage, right behind where you were laying down. Around the house stands three taller wooden cutouts of trees.

* * *

>unlock door
What do you want to unlock the black door with?

>drop big key
Dropped.

>unlock door
What do you want to unlock the black door with?

* * *

>unlock door with small key
You unlock the black door.

>open door
    *** You Win ***

Would you like to RESTART, RESTORE a saved game, QUIT or UNDO the last command?

* * *

>take grabber
Now you can get the key.

>get key
Taken.

* * *

>w
Stage Middle
A big wooden cutout of a yellow house with a red roof and a red door stands front and center of the stage, right behind where you were laying down. Around the house stands three taller wooden cutouts of trees.

>unlock door with big key
You unlock the red door.

>n
(first opening the red door)

Backstage
It's kind of dark. From the lights on the top of the stage, you can make out an empty lightbulb socket embedded in the ceiling.

>s
Stage Middle
A big wooden cutout of a yellow house with a red roof and a red door stands front and center of the stage, right behind where you were laying down. Around the house stands three taller wooden cutouts of trees.

* * *

>s
Studio Audience
Right in front of the stage, you see two cameras and two lights fixed on low stands.

Immediately, you notice something peculiar. You turn towards the stage, then towards the chairs. Facing the stage, all the chairs on the left are red, in the middle blue, and on the right green.

You can see a black door here.

>take lights
That's hardly portable.

>take chair
You can't see any such thing.

>x door
Kind of a dark gray-ish color. Above the door is a sign that says in big bold red letters, "EXIT".

>x lights
The lights they use on the show. They are currently off.

In Lights is lightbulb.

* * *

>take lightbulb
You try pulling it out, but it's stuck. However, you try again, and you feel it wiggle around a little bit.

>try again
That's not a verb I recognise.

>pull lightbulb
It is fixed in place.

>unscrew lightbulb
You unscrew the lightbulb.

* * *

>n
Backstage
It's kind of dark. From the lights on the top of the stage, you can make out an empty lightbulb socket embedded in the ceiling.

>screw light bulb
I only understood you as far as wanting to screw lightbulb.

>put light bulb into socker
I didn't understand that sentence.

>oops socket
That's not a verb I recognise.

I beg your pardon?

>put light bulb into socket
I didn't understand that sentence.

>put lightbulb into socket
You screw in the lightbulb.

>turn on liught
You can't see any such thing.

>turn on light
You turn on the light. Now you can see a safe embedded in the center of the back wall.

* * *

>x safe
It has a number pad and a seven-segment display, almost like a microwave, but super secure. The display is divided into three segments, red, blue, and green.

Passcode?

>safe
The safe remains closed.

Would you like to try again? (Yes or No)

>ryes
Would you like to try again? (Yes or No)

>yes
Please enter the passcode now.

>1234
That's not a verb I recognise.

Please enter the passcode now.

>1234
That's not a verb I recognise.

Please enter the passcode now.

>safw
That's not a verb I recognise.

Please enter the passcode now.

>saf
That's not a verb I recognise.

Please enter the passcode now.

>safe
That's not a verb I recognise.

Please enter the passcode now.

>eedeeddd
That's not a verb I recognise.

Please enter the passcode now.

>undo
Backstage
[Previous turn undone.]

Please enter the passcode now.

>undo
Backstage
[Previous turn undone.]

Please enter the passcode now.

* * *

>e
Stage Middle
A big wooden cutout of a yellow house with a red roof and a red door stands front and center of the stage, right behind where you were laying down. Around the house stands three taller wooden cutouts of trees.

>s
Studio Audience
Right in front of the stage, you see two cameras and two lights fixed on low stands.

Looking back at the whole stage, you see 2 trees in stage left, 3 trees in stage middle, and 1 tree in stage right. Peculiar.

left red

middle blue

right green

You can see a black door here.

* * *

>w
Stage Right
This part of the stage is pretty empty compared to the other two sections. Aside from the sky blue backdrop, there are two trees and a tall flagpole with a white flag.

>x flagpole
Smooth, polished, light gray steel. Like a normal flagpole but scaled down.

>x me
You're wearing long black pants that go down to your ankles, shiny black shoes, and a purple t-shirt. You feel around your head, and notice you have short hair. Probably black.

* * *

>x cutout
There are a lot of cutouts here. It would take a lot of time to examine all of them.

>x house
A sort of faded yellow-ish color.

>open door
It seems to be locked.

>x tree
You can't see any such thing.

>i
You are carrying nothing.

>e
Stage Left
Here there is a large, long, round cutout resembling some sort of lake. One giant fake oak tree stands closer to the house, with a large key dangling from its branches.

One of those long plastic grabber things is on the floor at the base of the tree. You can't seem to figure out why it's there.

On Big Oak Tree is big key.

You can also see grabber here.

* * *

>w
Stage Middle
A big wooden cutout of a yellow house with a red roof and a red door stands front and center of the stage, right behind where you were laying down. Around the house stands three taller wooden cutouts of trees.

>w
Stage Right
This part of the stage is pretty empty compared to the other two sections. Aside from the sky blue backdrop, there are two trees and a tall flagpole with a white flag.

>w
You can't go that way.

>e
Stage Middle
A big wooden cutout of a yellow house with a red roof and a red door stands front and center of the stage, right behind where you were laying down. Around the house stands three taller wooden cutouts of trees.

>n
(first opening the red door)
It seems to be locked.

* * *

>take key
You can't quite reach the key. It's too high up.

>take grabber
Now you can get the key.

* * *

>take key
Taken.

>w
Stage Middle
A big wooden cutout of a yellow house with a red roof and a red door stands front and center of the stage, right behind where you were laying down. Around the house stands three taller wooden cutouts of trees.

* * *

>w
Stage Right
This part of the stage is pretty empty compared to the other two sections. Aside from the sky blue backdrop, there are two trees and a tall flagpole with a white flag.

>x tree
You can't see any such thing.

>x flagpole
You can't see any such thing.

>x flag
You can't see any such thing.

>e
Stage Middle
A big wooden cutout of a yellow house with a red roof and a red door stands front and center of the stage, right behind where you were laying down. Around the house stands three taller wooden cutouts of trees.

>use key
That's not a verb I recognise.

>n
(first opening the red door)
It seems to be locked.

>unlock
What do you want to unlock?

>key
What do you want to unlock big key with?

>unlock door with big key
You unlock the red door.

* * *

>n
Backstage
It's kind of dark. From the lights on the top of the stage, you can make out an empty lightbulb socket embedded in the ceiling.

>turn on light
You can't see any such thing.

>s
Stage Middle
A big wooden cutout of a yellow house with a red roof and a red door stands front and center of the stage, right behind where you were laying down. Around the house stands three taller wooden cutouts of trees.

>n
Backstage
It's kind of dark. From the lights on the top of the stage, you can make out an empty lightbulb socket embedded in the ceiling.

* * *

>s
Stage Middle
A big wooden cutout of a yellow house with a red roof and a red door stands front and center of the stage, right behind where you were laying down. Around the house stands three taller wooden cutouts of trees.

>push trees
You can't see any such thing.

>n
Backstage
It's kind of dark. From the lights on the top of the stage, you can make out an empty lightbulb socket embedded in the ceiling.

* * *

>x door
You see nothing special about the red door.

>unlock door
(with the red door)
(first taking the red door)
That's hardly portable.

>open door
It seems to be locked.

>w
Stage Right
This part of the stage is pretty empty compared to the other two sections. Aside from the sky blue backdrop, there are two trees and a tall flagpole with a white flag.

* * *

>e
Stage Middle
A big wooden cutout of a yellow house with a red roof and a red door stands front and center of the stage, right behind where you were laying down. Around the house stands three taller wooden cutouts of trees.

>e
Stage Left
Here there is a large, long, round cutout resembling some sort of lake. One giant fake oak tree stands closer to the house, with a large key dangling from its branches.

On Big Oak Tree is big key.

You can also see grabber here.

>w
Stage Middle
A big wooden cutout of a yellow house with a red roof and a red door stands front and center of the stage, right behind where you were laying down. Around the house stands three taller wooden cutouts of trees.

* * *

>n
(first opening the red door)
It seems to be locked.

>s
Studio Audience
Right in front of the stage, you see two cameras and two lights fixed on low stands.

Immediately, you notice something peculiar. You turn towards the stage, then towards the chairs. Facing the stage, all the chairs on the left are red, in the middle blue, and on the right green.

You can see a black door here.

* * *

>n
Stage Middle
A big wooden cutout of a yellow house with a red roof and a red door stands front and center of the stage, right behind where you were laying down. Around the house stands three taller wooden cutouts of trees.

>e
Stage Left
Here there is a large, long, round cutout resembling some sort of lake. One giant fake oak tree stands closer to the house, with a large key dangling from its branches.

On Big Oak Tree is big key.

You can also see grabber here.

* * *

>x hosue
You can't see any such thing.

>x house
A sort of faded yellow-ish color.

* * *

>x roof
Brick red, with shingles painted onto it. Whoever was in charge of the artwork did a great job.

>x door
Solid bright red. It feels more alive than the rest of the set.

>x house
You can't see any such thing.

>x safe
You can't see any such thing.